1111111111111
10C00E0000001
100C000000P01
1111111111111